#######A#########
#       #       #
# ##### # ##### #
#   # # #     # #
# # # # ##### # #
#   # #       # # 
### # ####### # #
#   # #    #  # # 
# ### # ## # ##
#     # ##    # B
#################